1.1.1.1.1
111111111
11.....11
.1.....1.
.1.P...1.
.1211121.
.1.....1.
.1.....1.
.1..O..1.
.1211121.
.1.....1.
.1.....1.
.1....O1.
.1211121.
.1.....1.
.1.....1.
.1.....1.
.1.....1.
.1.....1.
.1.....1.
.1.....1.
.1.....1.
.1.....1.
.1211121.
