1.1.1.1.1
111111111
11..1..11
.1.....1.
.1.P...1.
.1222C21.
.1.....1.
.1.....1.
.1222221.
.1..G..1.
.1112221.
.1..O..1.
.11CCC11.
.1.C.C.1.
.1222221.
.1.W...1.
.1CCCCC1.
.1222221.
.1.....1.
.1..B..1.
.1C22221.
.1..22.1.
.1.....1.
.1222221.
.1.....1.
.1.CCC.1.
.1...C.1.
.1.CCC.1.
.1.C...1.
.1.CCC.1.
.1.....1.
.1O....1.
.1222221.
.1222221.
.1.....1.
.1CC2221.
.1.111.1.
.1.....D.
111111111
1111111111
1111111111
1111111111
1111111111
1111111111
1111111111