.1.....1.
.1.....1.
.1.....1.
.1.....1.
.1.....1.
.1.....1.
.1.....1.
.1..P..1.
.1222221.
.1222221.
.1....O1.
.1.2.221.
.1.....1.
.1111..1.
.1.O.O.1.
.1222221.
.1.....1.
.1.....1.
.12222.1.
.1.....1.
.1.....1.
.11212.1.
.1.....1.
.11.1.21.
.1.....1.
.1211121.
.1.....1.
.1.....1.
.1.....1.
.1.....1.
.1.....1.
.1.....1.
.1.....1.
.1.....1.
.1.....1.
.1.....1.
.1.....1.
.1.....1.
.1.....1.
.1.....1.
.1.....1.
.1.....1.
.1.....1.
.1.....1.
.1211121.
