1.1.1.1.1
111111111
11..1..11
.1.....1.
.1.P...1.
.1.....1.
.1.....1.
.1CCCCC1.
.1.....1.
.1.....1.
.1.....1.
.1..C..1.
.1.WCGG1.
.111CCC1.
.1.....1.
.1.....1.
.1.....1.
.1.....1.
.1.G...1.
.1CCCCC1.
.1CCCCCD.
111111111
