1.1.1.1.1
111111111
11..1..11
.1.....1.
.1.P...1.
.1CC.CC1.
.1.....1.
.1.O...1.
.1CC.CC1.
.1.....1.
.1.....1.
.1.....1.
.1.....1.
.1.....1.
.1.....1.
.1.....1.
.1.....1.
.111D111.
111111111