1.1.1.1.1
111111111
11.....11
.1.....1.
.1.P...1.
.12....1.
.1.2...1.
.1..2..1.
.1...2.1.
.1....21.
.1.....1.
.1.....1.
.1.....1.
.1.....1.
.1.2...1.
.1..2..1.
.1...2.1.
.1.....1.
.111D111.
.1222221.