1.1.1.1.1
111111111
11..1..11
.1.....1.
.1.P...1.
.1CC.CC1.
.1.....1.
.1.W...1.
.1CC.CC1.
.1.....1.
.1.....1.
.1.....1.
.1.CCC.1.
.1.O.C.1.
.1CCCCC1.
.1.C...1.
.1.CCC.1.
.1.....1.
.1.....1.
.1..W..1.
.1CCCCC1.
.1...C.1.
.1..CC.1.
.1...C.1.
.1.CCC.1.
.1.CCC.1.
.1...C.1.
.1.....1.
.1...G.D.
111111111
