1.1.1.1.1
111111111
11.....11
.1.....1.
.1.P...1.
.12111C1.
.1.....1.
.1.....1.
.1..OCC1.
.1211121.
.1.....1.
.1.....1.
.1....O1.
.1211121.
.1.....1.
.1.....1.
.1111121.
.12C2211.
.1222111.
.1...001.
.1.....1.
.1.....1.
.1.....1.
.1211121.
